WWWWWWWWWWWWWWW
WX  O     O  1W
W W W W W W W W
W   O     O   W
WOWOW W W WOWOW
W             W
W W W W W W W W
W             W
WbWBWfWFWHWSWwW
W             W
WOWOW W W WOWOW
W   O     O   W
W W W W W W W W
W2  O     O  3W
WWWWWWWWWWWWWWW