WWWWWWWWWWWWWWW
WX    B f1   2W
W W WOW WOW W W
W   O     O   W
W WOW W W WOW W
W O         O3W
WbW W W W W WFW
W             W
WOW W W W W WHW
W9O         O4W
W WOW W W WOW W
W   O     O   W
W W WOW WOW W W
W8   7w S6   5W
WWWWWWWWWWWWWWW