WWWWWWWWWWWWWWW
WX    O O    1W
W W W W W W W W
W     O O     W
W W W W W W W W
W     O O4    W
WbWOWfWOWHWOWwW
W     O O     W
WOWBWOWFWOWSWOW
W    5O O6    W
W W W W W W W W
W     O O     W
W W W W W W W W
W2    O O    3W
WWWWWWWWWWWWWWW