oooooooooooooooooooo
#M   E  L A N C I a
# ###o ### ### ### #
# # #o ### #  M    #
# ### o### ####### #
#                  #
# # ###### ####### #
# #      # #     # #
#o#o###o # o oM  # #
#        # #     # #
# ##o#### ###o# ## #
# #o   o    #  M   #
#    #  #   # # oo #
# ### # ## ## # ## #
###  M           # #
# ##o# ### #### ## #
# #    #     o   # #
# ## ###P#F#e#m#S# #
   f    H  g #   S
             o