##################
#M   E  L          #
# ###  ### ### ### #
# # #  ### #  M    #
# ### o### ####### #
#                  #
# # ###### ####### #
# #      # #     # #
#o#####  #    M  # #
#        # #     # #
# ############# ## #
#   #  o    #  M   #
#   #       #      #
# ### #### #### ## #
###  M #     o   # #
# ##o# ### #### ## #
# #    #     o   # #
# ## ###P#F#e#m#S# #
   f    H  g #   S
             o