####################
#      EEEE        #
# ###  ### ### ### #
# # #  ### #  M    #
# ### o### ####### #
#                  #
# # ###### ####### #
# #      # #     # #
#o#####  #    M  # #
#  E     # #     # #
# ############# ## #
#   #  o    #  M   #
#   #       #      #
# ### #### #### ## #
###  M #  E  #   # #
# #### ### #### ## #
# #    #   EEE   ###
# ## ############# #
#        H   E   M #
##############o#####
