####################
#MEL               #
# ###  ### ### ### #
# # #  ### #  M    #
# ### o### ####### #
#                  #
# # ###### ####### #
# #      # #     # #
#o#####  #    M  # #
#        # #     # #
# ############# ## #
#   #  o    #  M   #
#   #       #      #
# ### #### #### ## #
###  M #     #   # #
# #### ### #### ## #
# #    #         ###
# ## ############# #
#        H       M #
##############o#####
