####################
#                  #
# ###  ### ### ### #
# # #  ### #  M    #
# ### o### ####### #
#                  #
# # ###### ####### #
# #      # #     # #
#o#####  #    M  # #
#LLLL    # #     # #
# ############# ## #
#   #  o    #  M   #
#   #       #      #
# ### #### #### ## #
###  M #     #   # #
# #### ### #### ## #
# #    #  LLLLLL ###
# ## ############# #
#LLL     H    MM M #
##############o#####
