####################
# H       o   M    #
#o# # #o# # # # # ##
#    o    M      o #
#o# # # # # # #E#o##
#o         o      o#
# #o# #o# #o# # # ##
#o   o          o  #
# # # # # # # # # ##
#    o            #
# # # # # # # # # ##
#    o     M     o #
# # # # # #o# # # ##
#    o    M        #
# # # # # # # # # ##
#      o  L        #
#o# #F#o# # #o#M#o##
#          o       #
# #E# # # #o# #o # #
######F#o#o#######o#

