WWWWWWWWWWWWWWW
WB    OOO OOOOW
W W W W W W W W
W         O O W
WOW W W WEWOW W
W          O  W
W W W W W W W W
WO   O        W
W W W W WOW W W
W     OO      W
W WOW W W WEWOW
W        O    W
WWWWWWWWWWWWWWW