# o # #oo# # # # # #
#o#o#  #o# #o# #o#o#
#o#o#  #o# #o Mo #o#
# ### o### ##### #o#
#       M          #
# # ###L## ###e### #
# #      # #     # #
#o##F## o#    oM #o#
#  E     # #  oo # #
# ####F#o#o#### ##o#
#   o  o E  #  M   #
#   #o  o o # o#o#m#
# ### #### #### ##S#
##o  M #     #   #o#
# #o## ### #e##M##o#
# #    #   L     #o#
# ## ##o##o#######o#
#        H    E  oM#
##############P#####
