# o # #oo# # # # # #
#o#o#  #o# #o# #o#o#
#o#o#  #o# #o Mo #o#
# ### o### ##### #o#
#                  #
# # ###### ###e### #
# #      # #     # #
#o##F## o#    oM #o#
#        # #  oo # #
# ####F#o#o#### ##o#
#   o  o    #  M   #
#   #o  o o # o#o#m#
# ### #### #### ##S#
##o  M #     #   #o#
# #o## ### #e## ##o#
# #    #         #o#
# ## ##o##o#######o#
#        H       oM#
##############P#####
