WWWWWWWWWWWWWWW
WX  O1    b  2W
W W W W W W W W
W   O    1O2  W
WOWOWOWOWOWOWBW
W 7 O     O 3 W
W W W W W W W W
W   w  8  O   W
W W W W W W W W
W 7 O     O 3 W
WSWOWOWOWOWOWfW
W  6O  5  O4  W
W W W W W W W W
W6  H  5  F  4W
WWWWWWWWWWWWWWW